t b b b b b g g g g b b b b b t
t g g g g g g g g g g g g g g t
t g g w w g g g g g g w w g g t
t g g w w g g g g g g w w g g t
t g g w w g g g g g g w w g g t
t g g g g g g g g g g g g g g t
t t g g g 1 2 3 g g s g g g t t
t t t g w w w w w w w w g t t t
t t t w w w w w w w w w w t t t