t t g g g g g g t t g t t t t t
t t g g g w w w w w p t t t t t
t g g g w w w w w w w w g t t t
t c w w w w w w w w w w w t t t
t w w w w w w w w w w w w g t t
t w w w w w w w w w w w g g g t
t g w w w w w w p w g g g g g g
t t g g w w w w g g g g g g g g
t t t t t g g g g g t t t t t t