w w w w w w w w w w w w t t t t
w w w w w w w w w w w w g c t t
w w w w w w w w w w w g g g t t
w w w w w w w w w g g g g g t t
w w w w w w w w g g g g g g g t
w w w w g g g g g g g g g g g g
t t t g g g g g g g g g g g g g
t t g g o g g g g g g g g g g g
t t g g g g g t t n t t t t t t