b b b b b b l l b b b b b b b b
b b b b b b l l b b b b b b b b
b b b b b b l l b b b b b b b b
b b b b b b l l b b b b b b b b
b b b b b b l l b b b b b b b b
b b b b b b l l b b b b b b b b
b b b b l l b b l l b b b b b b
b b b b l l b b l l b b b b b b
b b b b b b b b b b b b b b b b