t t t t t t t t g g g g g g g t
t t w w w w w g g g n g g g t t
t w w w w w w g g g g g g g t t
t w w w w w w g g g g g g o t t
t w w w w w g g g g g g g g t t
g g g g g g g g g g g g g g t t
g o g g g g g g g g g g g t t t
g g g g g g g g g g t t t t t t
t t t t t t t g g g t t t t t t