b b b b b b b b b b b b b b b b
b b b b b b l b b b b b b b b b
b b b b b b b b b b b b b b b b
l l l l l l l l l l l l l l l l
l l l l l l l l l l l l l l l l
l l l l l l l l l l l l l l l l
b b b b b b b b b b b b b b b b
b b b b b b b b b b b b b b b b
b b b b b b b b b b b b b b b b