b b b b t g g g g g t t t t t t
b b g g g g g g g g g g g g g g
b c g g o g g g g g g g g g g g
b b b g g g g g g w w w w g g g
b b b b b b g g w w w w w w g g
b b b b g g g g w w w w w w g g
b b b g g g g g g w w w w w g g
b b b b g g g g g g g g g g g g
b b b b b b g g g g t t t t t t