t t t t t t t t t t w w w w w w
g g g g g g g g g g g g g g g g
g g t g g b t t t t t g g g g g
g g t g g g g g g g t g b g g g
g g g t t g g t g g g g g g g g
g g b g t g g n t g n b b g g g
g g g g b g t t t t t g g g g g
g g g g g g g g g g g g g g g g
t t t t t t t t t t t t t t t t