t t t t t t t g g g t t t t t t
t g o g g g t g g g t g g g g g
t g g g g g g g g g g g g g g g
t g g g g g g g g g g g g g g g
t g g g g g g g g g g g g g g g
t g g g g g g g g g w w w w w w
g g g g g g g o w w w w w w w w
g g t t g g g w w w w w w w w w
t t t o g g g w w w w w w w w w